SSSSSSSSSSSSSSSSSSSSSSSSSSSSSSSSSSS
S         S    S      SSSSS     S S
S SSS SSS S SSSSSSSSS     S SSS S S
S S SSS SSS S       S S S S S S S S
S S     S   S SSSSS S SSSSS S S S S
S SSSSS S SSS     S   S     S S   S
S     S S   S SSS SSSSS SSSSS SSS S
S SSSSS SSS S S S       S         S
S         S S S SSSSSSSSSSSSSSSSSSS
S SSSSSSS S S S    S    S         S
S S     S S S SSSS S SS SS SSSSSS S
S SSSSS S S S S       S    S      S
S     S S S S SSSSSSSSSSSSSS SSSSSS
S SSS S S S S            S   S    S
S   S S S S SSSSSSSSSSSS S SSS SS S
SSSSS S S S          S S S  S   S S
S     S S S SSS SS S S S S SS SSS S
S SSSSS S SSS S SS S S S S S  S S S
S S     S       SS S     S   SS S S
S SSS SSSSSSSSSSSSSSSSSSSSSSSSS S S
S   S                             S
SSS SSSSSSSSS SSSSSSS S SSSS SSSSSS
S S SS        S S     SSSS SSSS  SS
S S    SSS SS S SSS S S  S        S
S SS SSSS   SSS S S SSS SSSS S    S
S      S  S       S          SS  SS
SSSSSSSSSSSSSSSSSSSSSSSSSSSSSSSSSSS