SSSSSSSSSSSSSSSSSSSSSSSSSSSSSSSSSSSSSSSSSSSSSSSSS
S      S            S SS    S                  SS
S SS SSS S SS  SSS SS SSS S S SSSSSSSSSSSSSSSS  S
S S      S SSS   S  S S S S S S              SS S
S SSSS S SSS SSSSSS S S   S S SSSSSSSSSSSSSS  S S
S    SSS S        S S   S S S           SS SS S S
S SSSS S SSS S SSSSSS S S S SSSSSSSSSSS  S    S S
S  S       S S        SSSSS   S      SSS S SSSS S
S SSSSSSSS S SSSSSSSSSSS SSSS   S SSSS S S S    S
S      S                 S  SSS S      S S S S SS
S SS SSSSSSSSSSSSSSSSSSS S SS S SSSSSSSS S S S SS
S  S S                 S S               S S S SS
S SS SSSSSSSSSSSSSSSSSSS SSSSSSSSSSSSSSSSS S S SS
S S  S                 S S  S            S S S SS
S SS S S S S SSSSSSSSS SSS SS SSSSSSSSSS SSS S SS
S SSSSSSSS S S       S        S        S   S S SS
S  S     S S SS S SSSSSSSSSSSSSSSSSSSS SSS S S SS
SS S S S S S SS S    S      S        S   S S    S
SS S S S SSS SS SSSS   SSSS S SSSSSS SSS   S SSSS
SS S S S     SS    SSSSS  S S S   SS S SSS S   SS
SS S S SSSSSSSS SS     SS S S S SSS  S  SS SSS SS
SS S S           SSSSSSSS SSS S S S SSS      S SS
SS S SSSSSSSS SSSSS           S     SSSSSSSSSS SS
SS S    S   S   S S SSSSSSSS SSSSSS            SS
SS SSSS S S SSS S S S             SSSSSSSSSSSSSSS
SS S  S S S S     S SSSSSS SSSSSS           S   S
SS SS S S SSSSSSS S S      S    SSSSSSSSSSS S S S
SS SS S S         S SSSSSS SSSS  S      SSS   S S
SS SS S SSSSSSSSSSS S      S     S SSSS S SSSSS S
S     S             SSSSSSSSSSSS   S            S
SSSSSSSSSSSSSSSSSSSSSSSSSSSSSSSSSSSSSSSSSSSSSSSSS